WZ

Number of WZs found: 97 (14%)

WZAA - West Zone Award Authority

WZAC - West Zone Advisory Council

WZAF - Western Zone Abalone Fishery

WZAH - Wan Zuraidah Abdul Hamid

WZAS - Work Zone Analysis System

WZAW - Work Zone Awareness Week

WZBS - Wiadomosci Z Bialego Swiata

WZBW - was zu beweisen war.

WZCA - Wayne Zielke Chartered Accounta

WZCC - West Zone Cultural Centre

WZCE - Wei Zhong Chinese Environment

WZCF - World Zarathushti Cultural Foundation

WZCK - Wiz Zone Computers for Kids

WZCS - Wireless Zero Configuration service

WZCT - Western Zone Consideration Times

WZDA - Waar zit de arbeidsadviseur?

WZDG - We Zullen Door Gaan

WZDP - Web Zerviceh Developer Pack

WZDV - Wie Zoekt Die Vindt

WZEF - we zijn echt familie.

WZES - West Zephyrhills Elementary School

WZFC - W Z F resh C

WZFE - Wydzialu Zarzadzania Funduszami Europejskimi

WZFF - EWS 58 VARIOUS EWS POTENTIAL HIRE TO FRANCE

WZFH - EWS 58 TO EWS ACTS CONTRACT - HOLLAND

WZFO - Warzawskie Zaklady Foto Optyczne.

WZFR - warren zevon field recording

WZFS - EWS 58 SS EWS GIF CONTRACT - SPAIN

WZFW - WFW WDFW ZFW Can\'t find what

WZFX - W Z F o X

WZGF - EWS 56 VARIOUS EWS CONTRACT HIRE - FRANCE

WZHO - Watermaatschappij Zuid Holland Oost

WZHS - WZH Wissenschaftlichen Zentrum Heidelberg (German: Scientific

WZHZ - Waterleidingbedrijf Zuid Holland Zuid

WZIE - Wydzial Zarzadzania i Ekonomii

WZIF - Web Zerviceh Invocation Framework

WZIM - Wydzialu Zarzadzania i Marketingu

WZIR - Wielobranzowy Zaklad Inwestycji Rolniczych

WZJD - Wat Zou Jezus Doen?

WZJE - Wall Ztreet Journal Europe

WZJR - Whitefish Zoning Jurisdiction Regulations

WZJZ - W Z J az Z

WZKF - EWS 37 VARIOUS EWS POTENTIAL HIRE TO FRANCE

WZKH - White Zombie Kevin Hanser

WZKM - Wer Zuerst Kommt Mahlt

WZKS - EWS 37 SS EWS GIF CONTRACT - SPAIN

WZLA - Wielkopolski Zwiazek Lekkiej Atletyki

WZLF - W Z Wo LF Former

WZLM - Waters Zinc and Lead Mine

WZLO - Warszawa z lotu orla

WZLR - W Z C L ea R

WZMH - Webb Zerafa Menkes Housden

WZMJ - W Z M a J

WZMR - World Zelda Music Radio

WZMS - Work Zone Management and Safety

WZMX - W Z M i X

WZNC - Web Zone North Carolina

WZNM - Willem Zwijgt Niet Meer

WZNN - World Zoroastrian News Network

WZNW - Wess Zumino Novikov Witten

WZOA - Women\'s Zionist Organization of America

WZOD - Winged Zebras of Doom

WZOI - World Zoroastrian Organization of Individuals

WZPG - West Zone Parents Group

WZPZ - Wybrane zagadnienia psychologii zdrowia

WZRB - Weng Zheng Resources Bhd

WZRC - W Z R o C

WZRF - Web Zerviceh Rezource Framework

WZRR - W Z R ock and R

WZRT - W Z 97 R u T

WZRZ - Weiwuer Zizhiqu Renmin Zhengfu

WZSA - work zone self assessment

WZSC - Wechsler Zntellagence Scalefor Children

WZSG - Wij zijn straffe gasten

WZSK - Wirtshaus zum Schwarzen Keiler.

WZSL - Work Zone Speed Limit

WZSM - Work Zone Safety Manual

WZSO - Warszawskie Zaklady Sprzetu Ortopedycznego

WZSP - Wszystko Z Serca Prosto

WZSR - W Z S ta R

WZSS - Wenn Zwei Sich Streiten

WZTC - Work Zone Traffic Control

WZTD - W Z GS T elemun D

WZTF - War Zones Task Force

WZTK - W Z T al K

WZTL - Welspun Zucchi Textiles Limited

WZTM - Work Zone Traffic Management

WZTS - EWS 56 58 VARIOUS EWS TACTICAL STORED HIRE LOCOS

WZVC - Wyner Ziv video coding

WZWA - War Zone Wrestling Alliance.

WZWI - Wan Zulkafli Wan Ibrahim.

WZWN - Wess Zumino Witten Novikov

WZWR - Wszystko zostaje w rodzinie-svcd-SST.bin

WZWS - WILD ZOO Wall Shelf Coat

WZYC - World Zoroastrian Youth Congress-Pune

WZZF - Wybrane Zagadnienia z Filozofii

WZZG - Wybrane zagadnienia z geologii

A B C D E F G H I J K L M N O P Q R S T U V W X Y Z

WA WB WC WD WE WF WG WH WI WJ WK WL WM WN WO WP WQ WR WS WT WU WV WW WX WY WZ Top Missing Submit

Total number of Ws found: 8514 (14%)

This site collects cookies only through the third-party advertising of Google Ads. No other cookies are stored.