The 41st Metro Manila Film Festival (MMFF) awards night was held at the KIA Theater in Araneta Center, Quezon City Sunday, December 27.

Here is the full list of winners of MMFF 2015:

Best Actress: Jennylyn Mercado (Walang Forever)

Best Actor: Jericho Rosales (Walang Forever)

Best Picture: Walang Forever

2nd Best Picture: Buy Now, Die Later

3rd Best Picture: My Bebe Love: #KiligPaMore

2015 Gat Puno J. Villegas Cultural Award: My Bebe Love: #KiligPaMore

Best Supporting Actress: Maine Mendoza (My Bebe Love)

Best Supporting Actor: Tirso Cruz III (Honor Thy Father)

Best Director: Erik Matti (Honor Thy Father)

Best Screenplay: Paul Sta. Ana (Walang Forever)

Best Story: Dan Villegas and Antoinette Jadaone (Walang Forever)

Male Celebrity of the Night: Cesar Montano

Female Celebrity of the Night: Jennylyn Mercado

FPJ Memorial Award for Excellence: Walang Forever

Best Cinematography: Pao Orendain (Nilalang)

Best Film Editing: Jason Cahapay (Nilalang)

Best Production Design: (Buy Now, Die Later)

Best Visual Effects: (Nilalang)

Best Make-up Artist: Ryan Panaligan and Erika Racela (Honor Thy Father)

Best Original Theme Song: “Tao” by Armi Millare (Honor Thy Father)

Best Musical Score: Jessie Lasaten (Nilalang)

Best Sound: Ditoy Aguila (Nilalang)

New Wave Best Feature Film: Ari: My Life with a King

New Wave Special Jury: Toto

Manila Bulletin Best Feature Film: Ari: My Life with a King (New Wave)

New Wave Best Director: John Paul Su (Toto)

New Wave Best Actor: Francisco Guinto (Ari) & JM De Guzman (Tandem)

New Wave Best Screenplay: Robby Tantingco (Ari)

New Wave Best Supporting Actor: Thou Reyes (Toto)

New Wave Best Supporting Actress: Bibeth Orteza (Toto)

Best Child Performer: Krystal Brimmer (Honor Thy Father)

Best Festival Float: Buy Now, Die Later

New Wave Short Film Jury Prize: Daisy

New Wave Short Film Best Picture: Mumu

New Wave Animation Best Picture: Buttons

New Wave Animation Special Jury Prize: Little Lights

The eight movies that hit theaters last Friday, December 25 were My Bebe Love: #KiligPaMore; Beauty and the Bestie; Haunted Mansion; All You Need is Pag-ibig; Buy Now, Die Later; Walang Forever; Honor Thy Father; and Nilalang.